00000000000000000
00000000000000000
00333330000000000
03111113000000000
03111113000000000
03112113000000000
03111113000000000
03111113000000000
00333330000000000
00000000000000000
00000000000000000
00000000000000000
00000000000000000
00000000000000000
