00000000000000000
00000000000000000
00033300000000000
00311130000000000
00313130000000000
00313130000000000
00313130000000000
03113230000000000
00330000000000000
00000000000000000
00000000000000000
00000000000000000
00000000000000000
00000000000000000
