00003330000000000
00034113000000000
00031311300000000
00311131300000000
00313131130000000
00313113130000000
03111313130000000
03111323130000000
00333311130000000
00000033300000000
00000000000000000
00000000000000000
00000000000000000
00000000000000000
