00000000000000000
00000333300000000
00003111130000000
00003133130000000
00333133133333300
03111111111111300
03133333333331300
03131111111111300
03131333333331300
03131332111131300
03131111333131300
03133333333131300
03111111111111300
00333333333333000
